100000000000000100000000000001
000000000000000100000000000000
001001100110000000011001100100
000000000100000000001000000000
000010000000000100000000010000
000000000001000100100000000000
222000100000001100000001000333
242600110000011110000011007353
222000100000001100000001000333
000000000001001000100000000000
110001100000001000000001100011
000000000100000000001000000000
000100000110000000011000001000
000000100000001000000010000000
000000100000001000000010000000
