2220000001000000000001000000
2420000001000000000001000000
2226000000001001100001001000
0000000000001001100001001000
1111000100010000110000001000
0000000000110000000000001000
0010000001100110001111111100
0011111111000110011000000100
0001000000000000110000000000
0001000000110000100010001111
0001001000011001000000000000
0001001000011001000000007333
0000001000000000001000000353
0000001000000000001000000333
