0000000000000000000000
0011111100000011111100
0011111000110001111100
0000000001111000000000
2000000010000100000003
4600000000000000000075
2000000010000100000003
0000000001111000000000
0011111000110001111100
0011111100000011111100
0000000000000000000000
