2220000001000000000001000000
2420000001000000000001000000
2226000000001001000001000000
0000000000001001000001000000
1111000100010000110000000100
0000000000100000000000000100
0000000001100110001111111100
0011111111000110011000000000
0010000000000000010000000000
0010000000110000100010001111
0000001000001001000000000000
0000001000001001000000007333
0000001000000000001000000353
0000001000000000001000000333
