0000001111111111
0111111000010000
1100000011111111
0100101110111000
0110111000111100
0010101100111110
1010101110111111
0010111100001111
