0000000000000000000000
0011111100000011111100
0011111000110001111100
0000000001111000000000
2000000011111100000003
4600100000000000010075
2000000011111100000003
0000000001111000000000
0011111000110001111100
0011111100000011111100
0000000000000000000000
