000000000000000000000000000000000000000000
000000000000000000000000000000000000000000
000000001111111101100001101111111000000000
000000001100000001100001100111111100000000
000000001111111101100001100111111000000000
000000000000001101100001100100000000000000
000000001111111101111111101110000000000000
000000000000000000000000000000000000000000
000000001111111101111111000111111000000000
222000000100000100111111101100001100000333
242060000111100000111111001100000000007353
222000000100000100101100001100001100000333
000000001111111101100011100111111000000000
000000000000000000000000000000000000000000
000000001111111101111000001111000000000000
000000000100000100110000000110000000000000
000000000111100000110000100110000100000000
000000000100000100110000100110000100000000
000000001111111101111111101111111100000000
000000000000000000000000000000000000000000
000000000000000000000000000000000000000000
