000000000000000100000000000000
000000000000000100000000000000
000000000110000000011000000000
000000000100000000001000000000
000000000000000000000000000000
000000000001000100100000000000
222000100000001100000001000333
242600100000011110000001007353
222000100000001100000001000333
000000000001001000100000000000
000000000000000000000000000000
000000000100000000001000000000
000000000110000000011000000000
000000000000001000000000000000
000000000000001000000000000000
