0000000000000000000000
0011111100000011111100
0011111000000001111100
0000000001111000000000
0000000011111100000000
0000000000000000000000
0000000011111100000000
0000000001111000000000
0011111000000001111100
0011111100000011111100
0000000000000000000000
